****************************************
**一教************二教*********三教***
**********四教***********五教**********
********************************九教***
***六教******七教********八教*********
***********十教******十一教***十二教**
********学活***************************
****************************************